derp 25 62 64 64
2 1 2 1 2 1 2 1 2 1 2 1 2 1 2 1 2 1 2 1 2 1 2 1 2 1 2 1 2 1 2 1 2 1 2 1 2 1 2 1 2 1 2 1 2 1 2 1 2 1 2 1 2 1 2 1 2 1 2 1 2 1
2 1 2 1 2 1 2 1 2 1 2 1 2 1 2 1 2 1 2 1 2 1 2 1 2 1 2 1 2 1 2 1 2 1 2 1 2 1 2 1 2 1 2 1 2 1 2 1 2 1 2 1 2 1 2 1 2 1 2 1 2 1
2 1 34 7 8 9 34 34 34 34 34 34 34 8 9 27 28 34 34 34 11 16 34 34 34 8 9 23 24 34 34 34 13 14 8 9 34 11 16 34 34 11 16 8 9 23 24 34 34 34 34 34 11 16 34 34 34 34 11 16 2 1 
2 1 34 34 35 36 34 34 34 34 34 18 17 35 36 29 34 34 10 10 10 10 34 34 34 35 36 25 26 18 17 34 34 34 35 36 34 10 10 34 34 10 10 35 36 25 26 34 34 34 18 17 10 10 34 34 34 34 12 15 0 0 
2 1 2 1 35 36 3 4 34 34 22 11 16 35 36 30 34 34 10 10 10 10 34 34 34 35 36 27 28 11 16 34 34 34 35 36 34 10 10 34 34 10 10 35 36 27 28 34 34 34 11 16 10 10 34 34 34 34 13 14 0 0 
2 1 34 34 35 36 34 5 4 34 34 12 15 35 36 32 34 34 10 10 10 10 34 34 34 35 36 29 34 10 10 34 34 34 35 36 34 10 10 34 7 10 10 37 36 32 34 34 34 34 12 15 10 10 34 34 34 34 34 34 0 0 
2 1 34 22 35 36 34 6 5 4 34 13 14 35 36 33 34 34 10 10 10 10 34 34 34 35 36 30 34 10 10 34 34 34 35 36 34 10 10 34 34 10 10 38 36 33 34 34 34 34 13 14 10 10 34 34 39 3 2 1 2 1 
2 1 34 34 35 36 34 18 17 5 4 34 34 35 36 34 34 34 12 15 34 34 18 17 34 35 36 31 34 10 10 18 17 34 35 36 34 34 34 34 34 34 34 35 36 34 34 34 34 34 34 34 34 34 34 39 40 34 18 17 2 1 
2 1 2 1 2 1 2 11 16 6 2 1 2 1 3 4 34 34 13 14 34 7 11 16 34 35 36 31 34 10 10 11 16 34 35 36 34 7 34 34 39 3 2 1 2 1 2 1 2 1 2 1 2 1 2 1 21 34 11 16 2 1 
2 1 34 34 8 9 34 12 15 34 34 34 34 8 9 5 4 34 34 34 34 34 12 15 34 37 36 32 34 10 10 12 15 34 35 36 34 34 34 39 40 12 15 8 9 12 15 34 34 34 34 34 34 34 34 34 34 34 12 15 2 1 
2 1 34 34 35 36 34 13 14 34 34 34 34 35 36 34 5 4 34 34 34 34 13 14 34 38 36 33 34 10 10 13 14 34 35 36 34 34 39 40 34 13 14 35 36 13 14 34 34 34 34 34 22 34 34 34 7 34 13 14 2 1 
2 1 34 34 42 41 34 34 34 34 34 34 34 42 41 34 34 5 4 34 34 34 34 34 34 42 41 34 34 34 34 34 34 34 42 41 34 39 40 34 34 34 34 42 41 34 34 34 34 34 34 34 34 34 34 34 34 34 34 34 2 1 
2 1 2 1 2 1 2 1 2 1 2 1 2 1 2 1 2 1 2 1 3 4 34 34 34 1 2 1 2 1 2 1 2 1 2 1 2 1 2 1 2 1 2 1 2 34 34 34 39 3 2 1 2 1 2 1 2 1 2 1 2 1 
8 9 23 24 34 34 11 16 8 9 27 28 34 34 13 14 8 9 23 24 34 5 4 34 34 34 13 14 34 34 34 34 35 36 27 28 34 34 34 13 14 34 34 13 14 34 34 39 40 21 34 34 34 34 34 34 34 34 11 16 8 9 
35 36 25 26 34 34 12 15 35 36 32 34 34 34 34 34 35 36 25 26 34 34 5 4 34 34 34 34 34 34 22 34 35 36 29 34 10 10 34 34 34 34 34 34 34 34 39 40 34 34 34 34 34 34 34 7 34 34 12 15 35 36 
35 36 27 28 34 34 13 14 35 36 33 34 34 34 34 34 35 36 27 28 34 34 34 2 2 1 3 3 4 34 34 34 35 36 32 34 10 10 34 7 34 34 34 39 3 2 1 2 1 3 3 4 34 34 34 34 34 34 13 14 35 36 
35 36 29 34 10 10 34 34 35 36 18 17 10 10 34 34 35 36 29 34 34 34 34 34 34 34 34 34 5 4 34 34 35 36 33 34 10 10 34 34 34 34 39 40 34 8 9 12 15 34 34 5 4 34 34 34 34 34 34 34 35 36 
35 36 30 34 10 10 34 34 35 36 11 16 10 10 34 34 35 36 30 34 34 7 34 34 34 6 34 34 34 5 4 34 35 36 34 34 10 10 34 34 34 39 40 6 34 35 36 13 14 34 6 34 5 4 34 34 34 34 34 34 35 36 
35 36 31 34 10 10 34 34 35 36 12 15 10 10 34 34 35 36 31 34 34 34 34 34 34 34 34 34 34 34 5 4 42 41 34 34 34 34 34 34 39 40 34 18 17 35 36 34 34 34 34 34 34 5 4 34 34 34 34 34 37 36 
35 36 31 34 10 10 34 34 35 36 13 14 10 10 34 34 35 36 32 34 34 34 39 3 2 1 2 1 2 1 2 1 2 1 2 1 2 1 2 1 2 1 34 11 16 35 36 2 34 34 34 39 3 1 2 1 2 1 2 1 38 36 
35 36 32 34 10 10 34 34 35 36 34 22 10 10 34 34 37 36 33 34 34 39 40 13 14 34 8 9 34 34 34 34 8 9 12 15 2 1 2 1 34 34 34 12 15 35 36 34 34 34 39 40 34 34 34 34 34 34 12 15 35 36 
35 36 33 34 10 10 34 34 35 36 34 34 10 10 34 34 38 36 34 34 39 40 34 34 34 34 35 36 34 22 34 34 35 36 13 14 2 1 34 34 34 34 34 13 14 37 36 7 34 39 40 21 34 34 34 7 34 34 13 14 35 36 
42 41 34 34 34 34 34 34 42 41 34 34 34 34 34 34 42 41 34 39 40 34 34 34 34 34 35 36 34 34 34 34 35 36 34 34 2 1 34 34 34 34 34 34 34 42 41 34 39 40 34 34 34 34 34 34 34 34 34 34 42 41 
2 1 2 1 2 1 2 1 2 1 2 1 2 1 2 1 2 1 2 1 2 1 2 1 2 1 2 1 2 1 2 1 2 1 2 1 2 1 2 1 2 1 2 1 2 1 2 1 2 1 2 1 2 1 2 1 2 1 2 1 2 1
2 1 2 1 2 1 2 1 2 1 2 1 2 1 2 1 2 1 2 1 2 1 2 1 2 1 2 1 2 1 2 1 2 1 2 1 2 1 2 1 2 1 2 1 2 1 2 1 2 1 2 1 2 1 2 1 2 1 2 1 2 1


