derp 33 32 64 64
51 51 54 55 51 51 51 60 2 1 2 1 54 55 51 51 51 60 54 55 51 51 51 51 51 51 54 55 51 51 51 51 
51 51 54 55 58 52 53 51 2 1 2 1 56 55 88 51 51 51 54 55 51 51 88 51 51 69 54 55 88 52 53 51 
51 51 54 55 51 51 51 51 2 1 51 51 57 55 51 51 51 51 54 55 51 51 51 51 51 60 54 55 51 51 51 51
51 52 54 55 51 51 51 51 2 1 51 51 54 55 51 51 53 51 54 55 51 51 51 51 51 52 54 55 51 51 51 51
2 1 2 1 2 1 2 1 2 1 2 1 2 1 2 1 2 1 2 1 3 65 51 51 51 3 2 1 2 1 2 1
61 62 61 62 51 58 61 62 61 62 58 69 61 62 61 62 61 62 61 62 58 52 65 51 61 62 61 62 61 62 51 52
63 64 63 64 51 51 63 64 63 64 51 60 63 64 63 64 63 64 63 64 51 51 52 65 63 64 63 64 63 64 88 51 
51 51 51 52 51 51 51 51 51 52 51 51 51 52 53 51 51 52 53 51 53 51 51 52 65 51 51 52 53 51 51 51 
2 1 2 1 2 1 51 51 51 66 3 3 2 1 2 1 2 1 2 1 51 51 51 51 52 65 51 51 2 1 2 1 
67 51 67 51 67 51 51 51 66 53 51 67 51 67 51 67 51 67 51 67 51 52 53 51 51 52 65 51 67 51 67 51 
51 51 51 51 51 51 51 66 53 51 51 51 51 51 51 51 51 51 51 51 2 1 2 1 2 1 2 1 51 51 51 51 
54 55 63 64 51 51 66 53 51 51 63 64 63 64 51 51 63 64 63 64 63 64 63 64 54 55 63 64 63 64 2 1 
54 55 51 51 51 66 53 51 51 51 51 51 51 51 51 51 53 51 51 52 51 69 51 58 54 55 67 51 51 51 63 63 
54 55 51 51 66 53 51 51 88 51 2 1 2 1 2 1 2 1 2 1 51 60 51 51 54 55 51 51 51 51 63 63 
54 55 51 66 53 51 51 51 51 69 2 1 2 1 2 1 2 1 2 1 51 51 51 51 54 55 51 69 51 51 63 63 
54 55 2 1 2 51 51 51 51 60 51 51 51 51 2 1 2 1 2 1 51 51 51 51 54 55 51 60 51 1 2 1 
54 55 51 69 51 51 51 52 51 51 51 51 51 51 2 1 2 1 2 1 51 51 51 51 54 55 51 51 67 51 67 51 
54 55 51 60 51 51 51 3 2 1 2 1 2 1 2 1 2 1 2 1 2 1 2 1 2 1 3 65 51 51 51 51 
54 55 88 51 51 69 51 51 2 1 2 1 2 1 2 1 2 1 2 1 2 1 2 1 54 55 51 52 65 51 51 69 
56 55 51 51 51 60 51 51 51 51 51 51 51 51 2 1 2 1 2 1 51 51 51 51 54 55 51 51 52 65 51 60 
73 74 51 51 51 51 51 51 51 51 51 51 51 51 2 1 2 1 2 1 51 51 51 51 73 74 53 51 51 52 65 51 
2 1 3 65 51 51 51 3 2 1 2 1 2 1 2 1 2 1 2 1 2 1 2 1 2 1 51 51 51 51 2 1 
2 1 51 52 65 51 51 63 63 63 63 63 54 55 63 64 63 64 54 55 63 64 63 64 63 64 51 51 66 3 2 1 
2 1 51 51 52 65 51 63 63 63 63 63 56 55 51 69 53 51 54 55 53 51 51 69 51 51 51 66 53 51 2 1 
2 1 51 51 51 52 65 63 63 63 63 63 57 55 88 60 51 51 54 55 51 58 51 60 51 51 66 53 51 88 2 1 
2 1 51 69 51 51 2 1 63 63 63 63 54 55 53 51 51 51 54 55 53 51 51 51 51 66 53 51 51 69 2 1 
2 1 51 60 51 51 71 72 63 63 63 63 54 55 51 51 51 51 56 55 51 51 51 51 66 53 51 51 51 60 2 1 
2 1 2 1 2 1 56 55 2 1 63 63 2 1 2 1 2 1 2 1 51 51 51 66 53 51 2 1 51 51 2 1 
71 72 79 80 79 80 57 55 79 80 63 63 71 72 70 70 70 70 71 72 75 70 2 1 70 70 70 70 75 70 2 1 
54 55 78 78 78 78 54 55 78 78 63 63 54 55 70 70 70 70 54 55 63 63 63 63 63 63 63 63 2 1 2 1 
56 55 77 76 77 76 56 55 77 76 77 76 56 55 70 70 70 70 56 55 77 76 77 76 77 76 77 76 70 70 70 70 
81 82 81 82 81 82 81 82 81 82 81 82 81 82 81 82 81 82 81 82 81 82 81 82 81 82 81 82 81 82 81 82 
84 83 84 83 84 83 84 83 84 83 84 83 84 83 84 83 84 83 84 83 84 83 84 83 84 83 84 83 84 83 84 83

